NO ./textures/north.xpm
SO ./textures/south.xpm
WE ./textures/west.xpm
EA ./textures/east.xpm

C 255, 65, 23
F 255, 150, 100

111111
1000N1
100001   1111111
100001
111111     











