NO ./textures/north.xpm
F 60,40,30
SO ./textures/south.xpm
C 20,20,25
WE ./textures/west.xpm
EA ./textures/east.xpm

111111
100001
100N01
100001
111111
