NO ./textures/north.xpm
SO ./textures/south.xpm
WE ./textures/west.xpm
EA ./textures/east.xpm
F 60,40,30
C 20,20,25

111111111111111111111111
100000000000000000010001
100000000000000101010001
1000011101010111010N0111
110111111010001111010001
111111111111111111111111