NO ./textures/north.xpm
SO ./textures/south.xpm
WE ./textures/west.xpm
EA ./textures/east.xpm
F 60,40,30
C 20,20,25

1111111111111111111111111
1000000000110000000000001
1011000001110000000000001
100100000000000000000000111111111
111000000011000001110000000000001
100000000011000001110111111111111
11110000011111011100000010001
10000000000000011101010010001
11000000110101011100000010001
10000000000000001100000010001
10000000000000001101010010001
110000000010101111101111000111
111100000001011011100000111
1000000000110000000000001
1011000001110000000000001
100000000000000000000000111111111
100000011011000001110000000000001
100000000011000001110111111111111
11110001111111011100000010001
11110001111111011101010010001
11000000110101011100000010001
10000000000000001100000010001
10000000000000001101010010001
110000N111010101111101111000111
1111011111101011011101111111111111
11111111111111111111111111111111111
111111111111111111111111111